00000000000000
00111111111101
01C0100P000010
11000000000011
01001111100011
010X000E100C10
00111111111100
00001000010000