0000000000000000
0001111111111010
001C0000P000X100
0110X00000000110
00100000X00X0110
001X0000E000C100
0001111111111000
0000010000100000
0000000000000000